1 90 1 90 1 90 1 90 1 90 1 90 1 90 1 90 1 90 1 90 1 90 1 90 1 90 1 90 1 90 1 90 1 90 1 90 1 90 1 90
0 0 0 0 0 0 0 0 0 0 0 0 0 0 0 0 0 0 0 0 0 0 0 0 0 0 0 0 0 0 0 0 0 0 0 0 0 0 1 90
0 0 0 0 0 0 0 0 0 0 0 0 0 0 0 0 0 0 0 0 0 0 0 0 0 0 0 0 0 0 0 0 0 0 0 0 0 0 1 90
0 0 0 0 0 0 0 0 0 0 0 0 0 0 0 0 0 0 0 0 0 0 0 0 0 0 0 0 0 0 0 0 0 0 0 0 0 0 1 90
0 0 0 0 0 0 0 0 0 0 0 0 0 0 0 0 0 0 0 0 0 0 0 0 0 0 1 90 0 0 0 0 0 0 0 0 0 0 1 90
0 0 0 0 0 0 0 0 0 0 0 0 0 0 0 0 0 0 0 90 1 90 1 90 1 90 1 90 0 0 0 0 0 0 0 0 0 0 1 90
0 0 0 0 0 0 0 0 0 0 0 0 0 0 0 0 0 0 0 0 0 0 0 0 0 0 1 90 0 0 0 0 0 0 0 0 0 0 1 90
0 0 0 0 0 0 0 0 0 0 0 0 0 0 0 0 0 0 0 0 0 0 0 0 0 0 1 90 0 0 0 0 0 0 0 0 0 0 1 90
0 0 0 0 0 0 0 0 0 0 0 90 1 90 1 90 1 90 0 90 0 0 0 0 0 0 1 90 0 0 0 0 0 0 0 0 0 0 1 90
0 0 0 0 0 0 0 0 0 0 0 90 0 90 0 90 0 90 0 0 0 0 0 90 0 0 1 90 0 0 0 0 0 0 0 0 0 0 1 90
0 0 0 0 0 0 0 0 0 0 0 0 0 0 0 0 0 90 0 0 0 0 0 0 0 0 1 90 0 0 0 0 0 0 0 0 0 0 1 90
0 0 0 0 1 90 1 90 1 90 0 0 0 0 0 0 0 90 0 0 0 0 0 0 0 0 1 90 0 0 0 0 0 0 0 0 0 0 1 90
1 90 1 90 1 90 1 90 1 90 1 90 1 90 1 90 1 90 1 90 1 90 1 90 1 90 1 90 1 90 1 90 1 90 1 90 1 90 1 90